  ##### 
###   # 
#D@O  # 
### OD# 
#D##O # 
# # D ##
#O ROOD#
#   D  #
########