#######
###@# #
###OD #
# O   #
# D OD#
#     #
#######