########
#D # @##
#  # ###
#  O  ##
#OO##  #
#      #
#D # D##
########