########
###   ##
## O O@#
##  ####
##    ##
##   D##
#####D##
########