############
#@#  D#   D#
# # # # # ##
# O     O ##
# O  O##  ##
### # ### ##
###    D#D##
############