########
#D  @ D#
# #  ###
#      #
#  # # #
## D O #
## # #O#
## O O #
## # # #
##     #
######D#
########